------------------------------XXX-------------------------------
------------------------------XXX-------------------------------
------------------------------XXX-------------------------------
------------------------------XXX-------------------------------
------------------------------XXX-------------------------------
------------------------------XXX-------------------------------
--------------------O---------XXX-------------------------------
------------------------------XXX-------------------------------
------------------------------XXX-------------------------------
------------------------------XXX-------------------------------
------------------------------XXX-------------------------------
------------------------------XXX-------------------------------
------------------------------XXX-------------------------------
----------------------------------------------------------------
----------------------------------------------------------------
----------------------------------------------------------------
----------------------------------------------------------------
----------------------------------------------------------------
----------------------------------------------------------------
---------O--------------------XXX-------------------------------
--------------------O---------XXX-------------------------------
------------------------------XXX-------------------------------
------------------------------XXX-------------------------------
------------------------------XXX-------------------------------
------------------------------XXX-------------------------------
------------------------------XXX-------------------------------
------------------------------XXX-------------------------------
------------------------------XXX-------------------------------
------------------------------XXX-------------------------------
------------------------------XXX-------------------------------
------------------------------XXX-------------------------------
XXXXXXXXXXXX------XXXXXXXXXXXXXXXXXXXXXXXXXXXX------XXXXXXXXXXXX
XXXXXXXXXXXX------XXXXXXXXXXXXXXXXXXXXXXXXXXXX------XXXXXXXXXXXX
XXXXXXXXXXXX------XXXXXXXXXXXXXXXXXXXXXXXXXXXX------XXXXXXXXXXXX
------------------------------XXX-------------------------------
------------------------------XXX-------------------------------
------------------------------XXX-------------------------------
------------------------------XXX-------------------------------
------------------------------XXX-------------------------------
------------------------------XXX-------------O-----------------
------------------------------XXX-------------------------------
------------------------------XXX-------------------------------
------------------------------XXX-------------------------------
------------------------------XXX-----------------------O-------
------------------------------XXX-------------------------------
----------------------------------------------------------------
----------------------------------------------------------------
----------------------------------------O-----------------------
----------------------------------------------------------------
----------------------------------------------------------------
----------------------------------------------------------------
------------------------------XXX---------------------O---------
------------------------------XXX-------------------------------
------------------------------XXX-----------O-------------------
------------------------------XXX-------------------------------
------------------------------XXX-------------------------------
------------------------------XXX-------------------------------
------------------------------XXX-------------------------------
------------------------------XXX------------------------O------
------------------------------XXX-------------------------------
------------------------------XXX-------------------------------
------------------------------XXX-------------------------------
------------------------------XXX-------------------------------
------------------------------XXX-------------------------------
