+---------------+
| : : : : : : : |
| : : : : : : : |
| : : | | : : : |
| : : | | : : : |
| : : | | : | | |
| : : | | : : : |
| : : : : : : : |
| : : : : : : : |
+---------------+
