+---------------+
|A: : : : : : :B|
| : : : : : : : |
| : : | | : : : |
| : : | | : : : |
| : : | | : | | |
| : : | | : : : |
| : : : : : : : |
|C: : : : : : :D|
+---------------+
