+-------------------------------+
|A: : : : : : : : : : : : : : :B|
| : : : : : : : : : : : : : : : |
| : : : : : : : : : : : : : : : |
| : : : : : : : : : : : : : : : |
| : : : : : : : : : : : : : : : |
| : : : : | | : : : : : : : : : |
| : : : : | | : : : : : : : : : |
| : : : : | | : : : : : : : : : |
| : : : : | | : : : : | | | | | |
| : : : : | | : : : : : : : : : |
| : : : : | | : : : : : : : : : |
| : : : : : : : : : : : : : : : |
| : : : : : : : : : : : : : : : |
| : : : : : : : : : : : : : : : |
| : : : : : : : : : : : : : : : |
|C: : : : : : : : : : : : : : :D|
+-------------------------------+
