+-----------------------------------------------------------+
|B: : : : : : : : : : : : : : : : : : : : : : : : : : : : :A|
| : : : : : : : : : : : : : : : : : : : : : : : : : : : : : |
| : : : : : : : : : : : : : : : : : : : : : : : : : : : : : |
| : : : : : : : : : : : : : : : : : : : : : : : : : : : : : |
| : : : : : : : : : : : : : : : : : : : : : : : : : : : : : |
| : : : : : : : : : : : : : : : : : : : : : : : : : : : : : |
| : : : : : : : : : : : : : : : : : : : : : : : : : : : : : |
| : : : : : : : : : : : : : : : : : : : : : : : : : : : : : |
| : : : : : : : : : : : : : : : : : : : : : : : : : : : : : |
| : : : : : : : : : : : : : : : : : : : : : : : : : : : : : |
| : : : : : : : : : : : : : : : : : : : : : : : : : : : : : |
| : : : : : : : : : : : : : : : : : : : : : : : : : : : : : |
| : : : : : : : : : : : : : : : : : : : : : : : : : : : : : |
| : : : : : : : : : : : : : : : : : : : : : : : : : : : : : |
| : : : : : : : : : : : : : : : : : : : : : : : : : : : : : |
| : : : : : : : : : : : : : : : : : : : : : : : : : : : : : |
| : : : : : : : : : : : : : : : : : : : : : : : : : : : : : |
| : : : : : : : : : : : : : : : : : : : : : : : : : : : : : |
| : : : : : : : : : : : : : : : : : : : : : : : : : : : : : |
| : : : : : : : : : : : : : : : : : : : : : : : : : : : : : |
| : : : : : : : : : : : : : : : : : : : : : : : : : : : : : |
| : : : : : : : : : : : : : : : : : : : : : : : : : : : : : |
| : : : : : : : : : : : : : : : : : : : : : : : : : : : : : |
| : : : : : : : : : : : : : : : : : : : : : : : : : : : : : |
| : : : : : : : : : : : : : : : : : : : : : : : : : : : : : |
| : : : : : : : : : : : : : : : : : : : : : : : : : : : : : |
| : : : : : : : : : : : : : : : : : : : : : : : : : : : : : |
| : : : : : : : : : : : : : : : : : : : : : : : : : : : : : |
| : : : : : : : : : : : : : : : : : : : : : : : : : : : : : |
| : : : : : : : : : : : : : : : : : : : : : : : : : : : : : |
|C: : : : : : : : : : : : : : : : : : : : : : : : : : : : :D|
+-----------------------------------------------------------+
