--------
--------
XX------
--------
---X----
------XX
--------
--------
