--------------------------------
--------------------------------
--------------------------------
--------------------------------
--------------------------------
--------------------------------
--------------------------------
--------------------------------
--------------------------------
XXXXXXXXXXXX--------------------
XXXXXXXXXXXX--------------------
---------------O----------------
--------------------------------
--O-------O---------------------
--------------O----O------------
--------------------------------
--------XXXXXXXXXXXXXXX---------
--------XXXXXXXXXXXXXXX---------
--------------------------------
--------------------------------
--------------------------------
--------------------------------
--------------------------------
---------------------XXXXXXXXXXX
---------------------XXXXXXXXXXX
--------------------------------
--------------------------------
------------------O-------------
-------------------------O------
--------------------------------
--------------------------------
--------------------------------
