----------------
----------------
----------------
----------------
XXXXX-----------
----------------
O---------------
----------------
------XXXXX-----
----------------
----------------
------------XXXX
----------------
-----------O----
----------------
----------------
